REP Questions	Tracer - C2FS Answers	Date Added	Date Updated																						
What POS option that we offer would be good for the archery business?	Quantic, Clover, HubWallet																								
Can we integrate with this pos Epro?	No, they use Fluid Pay Direct																								
What are the Fees with Quantic?	The rep will quote the processing rates, Quantic will quote the hardware based on the merchants needs																								
Can we integrate with Epicor?	Yes, Via MiCamp																								
Who has the best price on a PAX terminal?	Clearent, or MiCamp																								
Can we integrate with Roommaster / InnQuest	Yes, Via MiCamp																								
Can we integrate with Quickbooks?	Yes, Via TRX and Clearent through Hyfin																								
Who do we use to setup Hyfin?	Clearent and TRX																								
Who do we use to setup Rectangle Health?	TSYS VAR via TRX, Clearent or MiCamp																								
Who offers restaurant POS?	Shift4, MiCamp, HubWallet																								
What are our restaurant POS systems? 	Skytab, Clover, Tabit, HubWallet																								
Who has the best food truck POS?	HubWallet, Quantic																								
Who offers a Salon POS?	HubWallet																								
Who offers ACH?	TRX, ACI, Clearent																								
Who do we use for gift cards?	Valutec, Factor4, Shift4, Quantic																								
What Gateways can we offer?	Authorize.net, Fluid Pay, Accept Blue, TRX, Clearent, MiCamp																								
Who do we use for High Risk?	TRX, Payment Advisors																								
Who do use for High Tickets?	TRX, MiCamp																								
Who has a mobile solution? 	TRX, Clearent, MiCamp																								
Who has a mobile solution that does true cash discount? 	TRX, MiCamp																								
Can we integrate with Roommaster / InnQuest	Yes, Via MiCamp																								
Can SwipeSimple do Dual Pricing?	Yes, Via MiCamp North																								
What industries work best with Quantic?	Retail, ecomm																								
Best POS for retail?	Quantic, Clover, HubWallet																								
What are Clover's costs, both monthly and hardware when ordering thru HubWallet?	The rep will quote the processing rates, Quantic will quote the hardware based on the merchants needs																								
Who offers the best POS for Liquor Stores?	Quantic 																								
What are the fees for the Clearent Mobile Solution? Including the Reader																									
Can we integrate with Aloha?	Clearent, MiCamp (Freedom pay or Connected payments w/ NCR for EMV)																								
Do we offer any kind of payroll services?	not currently																								
Where do we go to board Quantic POS?	Any TSYS Platform ( TRX )																								
What is the Customer support number for Clearent	866.435.0666 Option 1																								
What is the Customer support number for TRX	888-933-8797 Option 2																								
What is the Customer support number for MiCamp																									
What is the Customer support number for Merchant Lynx	844-200-8996 Option 2																								
What is the Customer support number for TSYS	877-608-6599																								
What is the Customer support number for Shift4	800-201-0461 Option 1																								
What is the Customer support email for Clearent	customersupport@clearent.com																								
What is the Customer support email for TRX	customersupport@trxservices.com																								
What is the Customer support email for MiCamp	Micamp@cocard.net																								
What is the Customer support email for Merchant Lynx																									
What is the Customer support email for TSYS	bf_partnersalessupport@globalpay.com																								
What is the Customer support email for Shift4																									
How do I order buisness cards	email cody																								
Who do I contact for my login and password informaiton to any platform?	Christy Milton																								
Does Swipe Simple offer Surcharging	Yes																								
What are Swipe Simple fees?	$20 monthly																								
who is our contact with Rectangle Health	sdwyer@rectanglehealth.com, Sallie Dwyer																								
Do we offer Visa, Mastercard or American Express Gift cards?	No, we dont offer any branded gift cards. We can only provide nonbranded cards. 																								
Who is the contact for Quantic	Nick Vitucci, nvitucci@getquantic.com																								
Do we have or offer small loan options? 	Yes, TRX - TuaPay, Contact Joy West																								
																									
																									
																									
																									
																									
																									
																									
																									
																									
																									
																									
																									
																									
																									
																									
																									
																									
																									
																									
																									
																									
																									
																									
																									
																									
																									
																									
																									
																									
																									
																									
																									
																									
																									
																									
																									
																									
																									
																									
																									
																									
																									
																									
																									
																									
																									
																									
																									
																									
																									
																									
																									
																									
																									
																									
																									
																									
																									
																									
																									
																									
																									
																									
																									
																									
																									
																									
																									
																									
																									
																									
																									
																									
																									
																									
																									
																									
																									
																									
																									
																									
																									
																									
																									
																									
																									
																									
																									
																									
																									
																									
																									
																									
																									
																									
																									
																									
																									
																									
																									
																									
																									
																									
																									
																									
																									
																									
																									
																									
																									
																									
																									
																									
																									
																									
																									
																									
																									
																									
																									
																									
																									
																									
																									
																									
																									
																									
																									
																									
																									
																									
																									
																									
																									
																									
																									
																									
																									
																									
																									
																									
																									
																									
																									
																									
																									
																									
																									
																									
																									
																									
																									
																									
																									
																									
																									
																									
																									
																									
																									
																									
																									
																									
																									
																									
																									
																									
																									
																									
																									
																									
																									
																									
																									
																									
																									
																									
																									
																									
																									
																									
																									
																									
																									
																									
																									
																									
																									
																									
																									
																									
																									
																									
																									
																									
																									
																									
																									
																									
																									
																									
																									
																									
																									
																									
																									
																									
																									
																									
																									
																									
																									
																									
																									
																									
																									
																									
																									
																									
																									
																									
																									
																									
																									
																									
																									
																									
																									
																									
																									
																									
																									
																									
																									
																									
																									
																									
																									
																									
																									
																									
																									
																									
																									
																									
																									
																									
																									
																									
																									
																									
																									
																									
																									
																									
																									
																									
																									
																									
																									
																									
																									
																									
																									
																									
																									
																									
																									
																									
																									
																									
																									
																									
																									
																									
																									
																									
																									
																									
																									
																									
																									
																									
																									
																									
																									
																									
																									
																									
																									
																									
																									
																									
																									
																									
																									
																									
																									
																									
																									
																									
																									
																									
																									
																									
																									
																									
																									
																									
																									
																									
																									
																									
																									
																									
																									
																									
																									
																									
																									
																									
																									
																									
																									
																									
																									
																									
																									
																									
																									
																									
																									
																									
																									
																									
																									
																									
																									
																									
																									
																									
																									
																									
																									
																									
																									
																									
																									
																									
																									
																									
																									
																									
																									
																									
																									
																									
																									
																									
																									
																									
																									
																									
																									
																									
																									
																									
																									
																									
																									
																									
																									
																									
																									
																									
																									
																									
																									
																									
																									
																									
																									
																									
																									
																									
																									
																									
																									
																									
																									
																									
																									
																									
																									
																									
																									
																									
																									
																									
																									
																									
																									
																									
																									
																									
																									
																									
																									
																									
																									
																									
																									
																									
																									
																									
																									
																									
																									
																									
																									
																									
																									
																									
																									
																									
																									
																									
																									
																									
																									
																									
																									
																									
																									
																									
																									
																									
																									
																									
																									
																									
																									
																									
																									
																									
																									
																									
																									
																									
																									
																									
																									
																									
																									
																									
																									
																									
																									
																									
																									
																									
																									
																									
																									
																									
																									
																									
																									
																									
																									
																									
																									
																									
																									
																									
																									
																									
																									
																									
																									
																									
																									
																									
																									
																									
																									
																									
																									
																									
																									
																									
																									
																									
																									
																									
																									
																									
																									
																									
																									
																									
																									
																									
																									
																									
																									
																									
																									
																									
																									
																									
																									
																									
																									
																									
																									
																									
																									
																									
																									
																									
																									
																									
																									
																									
																									
																									
																									
																									
																									
																									
																									
																									
																									
																									
																									
																									
																									
																									
																									
																									
																									
																									
																									
																									
																									
																									
																									
																									
																									
																									
																									
																									
																									
																									
																									
																									
																									
																									
																									
																									
																									
																									
																									
																									
																									
																									
																									
																									
																									
																									
																									
																									
																									
																									
																									
																									
																									
																									
																									
																									
																									
																									
																									
																									
																									
																									
																									
																									
																									
																									
																									
																									
																									
																									
																									
																									
																									
																									
																									
																									
																									
																									
																									
																									
																									
																									
																									
																									
																									
																									
																									
																									
																									
																									
																									
																									
																									
																									
																									
																									
																									
																									
																									
																									
																									
																									
																									
																									
																									
																									
																									
																									
																									
																									
																									
																									
																									
																									
																									
																									
																									
																									
																									
																									
																									
																									
																									
																									
																									
																									
																									
																									
																									
																									
																									
																									
																									
																									
																									
																									
																									
																									
																									
																									
																									
																									
																									
																									
																									
																									
																									
																									
																									
																									
																									
																									
																									
																									
																									
																									
																									
																									
																									
																									
																									
																									
																									
																									
																									
																									
																									
																									
																									
																									
																									
																									
																									
																									
																									
																									
																									
																									
																									
																									
																									
																									
																									
																									
																									
																									
																									
																									
																									
																									
																									
																									
																									
																									
																									
																									
																									
																									
																									
																									
																									
																									
																									
																									
																									
																									
																									
																									
																									
																									
																									
																									
																									
																									
																									
																									
																									
																									
																									
																									
																									
																									
																									
																									
																									
																									
																									
																									
																									
																									
																									
																									
																									
																									
																									
																									
																									
																									
																									
																									
																									
																									
																									
																									
																									
																									
																									
																									
																									
																									
																									
																									
																									
																									
																									
																									
																									
																									
																									
																									
																									
																									
																									
																									
																									
																									
																									
																									
																									
																									
																									
																									
																									
																									
																									
																									
																									
																									
																									
																									
																									
																									
																									
																									
																									
																									
																									
																									
																									
																									
																									
																									
																									
																									
																									
																									
																									
																									
																									
																									
																									
																									
																									
																									
																									
																									
																									
																									
																									
																									
																									
																									
																									
																									
																									
																									
																									
																									
																									
																									
																									
																									
																									
																									
																									
																									
																									
																									
																									
																									
																									
																									
																									
																									
																									
																									
																									
																									
																									
																									
																									
																									
																									
																									
																									
																									
																									
																									
																									
																									
																									
																									
																									
																									
																									
																									
																									
																									
																									
																									
																									
																									
																									
																									
																									
																									
																									
																									
																									
																									
																									
																									
																									
																									
																									
																									
																									
																									
																									
																									
																									
																									
																									
																									
																									
																									
																									
																									
																									
																									
																									
																									
																									
																									
																									
																									
																									
																									
																									
																									
																									
																									
																									
																									